{
  "levelName" : "Ride the Wave",
  "levelRows" : [
    "00000000000000",
    "00000000000000",
    "00110111111100",
    "00000000000100",
    "00000000000100",
    "00000000000100",
    "00111111000100",
    "00100000000100",
    "00101000000010",
    "00100000000100",
    "00111101111100",
    "00000000000000",
    "00000000000000"
  ]
}